0000000000000000000000000006
4444444444000070000000000006
3070000003111111111130000006
1111130003000000000032222222
0000030803000007000030000000
0000031111113111113110000000
0070030000003000003004400000
1111310000003008003000044000
0000300003111111311000000447
0000344443000000300800000001
0000300000003111111111300000
0000300000003111111111300000
1113111111111100070001111131
1113111111111103111301111131
0003000000900003111300070030
1111111111111111111111111111