0000000000060000600000000000
0000000000060000600000000000
0007080003160000613000807000
3111113443160000613443111113
3100013000160000610003100013
3100013000160000610003100013
3107013000160000610003107013
3111113000160000610003111113
3100013000160000610003100013
3100013444131111314443100013
3100010003130000313000100013
3187010003130078313000107813
3115110003122222213000115113
3000005003000000003005000003
3000000583000090003050000003
1111111111111111111111111111