0000000000000000006000000000
0000700000000000006000000000
1111111311111110006000000000
0000000344444444446000070000
0000000300001130001111111311
0000000300001130000000000300
0000080300001130000000780300
1131111100001111111131111111
0030000000000000000030000000
0030000000000080000030000000
1111111113111111111130000000
0000000003000000000030000000
0000000703444444444430007000
0000311111100000000011111113
0000300000000090070000000003
1111111111111111111111111111